10 10
15 15
0 0 0 0 0 0 0 0 0 2 0 0 0 0 2
0 0 0 0 0 0 0 0 0 0 0 0 2 0 2 
0 0 0 0 0 0 0 0 0 0 0 0 2 2 2 
2 2 0 0 2 2 2 2 2 2 0 0 0 0 0 
0 0 0 0 0 0 0 0 0 2 0 0 0 0 0 
0 0 0 0 0 0 0 0 0 2 0 0 0 0 0 
0 0 0 0 0 0 0 0 0 2 0 0 0 0 0 
0 0 0 0 0 0 0 0 2 2 0 0 0 0 0 
0 0 0 0 0 0 0 0 2 0 0 0 0 0 0 
2 2 2 2 2 0 2 2 2 2 2 0 0 2 2 
0 0 0 0 0 0 0 0 0 2 0 0 0 0 0 
2 0 0 0 0 0 0 0 0 2 0 0 0 0 0 
2 0 0 0 0 0 0 0 0 2 0 0 0 0 0 
2 1 0 0 0 0 0 0 0 2 0 0 0 0 0 
2 2 2 2 0 0 0 0 0 2 0 0 0 0 0 
7
3 12 5
7 9 8 7
7 13 1 9
4 2 1
4 6 1
6 5 6
5 4 11
3
10 6 13 6
3 11 11 0
11 8 13 11
levels\\level3.txt