0 0
30 7
0 0 2 2 2 2 2 2 2 2 2  2 2 2 2 2 2 2 2 2 2 2  2 2 2 2 2 2 2 2 
0 0 2 0 0 0 0 0 0 0 2  0 0 0 0 0 2 0 0 0 0 0  0 0 2 0 0 0 0 2 
0 2 2 2 2 0 0 0 0 0 2  2 0 0 0 0 2 0 0 0 0 0  0 0 2 0 0 0 0 1 
0 0 0 0 0 0 0 0 0 0 0  0 2 0 0 0 0 0 0 0 0 0  0 0 2 0 0 0 0 1 
2 2 0 2 2 0 0 0 0 0 2  0 0 0 0 0 2 0 0 0 0 0  0 0 2 0 0 0 0 1 
2 0 0 0 2 0 0 0 0 0 2  0 0 0 0 0 2 2 0 0 0 0  0 0 0 0 0 0 0 2 
2 2 2 2 2 2 2 2 2 2 2  2 2 2 2 2 2 2 2 2 2 2  2 2 2 2 2 2 2 2
9
6 3 1
6 9 3
5 14 3
5 12 1
4 9 3
4 8 1
3 25 3
5 27 2
6 26 4
3
17 3 5 4
13 1 5 2
8 1 1 0
levels\\bonuslevel.txt