1 18
20 20
2 2 2 2 2 2 2 2 2 2 2 2 2 2 2 2 2 2 2 2
2 0 0 0 0 0 0 0 2 0 0 0 0 0 0 0 0 0 0 2
2 0 0 0 0 0 0 0 0 0 0 0 0 0 0 0 0 0 0 2
2 0 0 0 0 0 0 0 2 0 0 0 0 0 0 0 0 0 0 2
2 0 0 0 0 0 0 0 2 2 2 0 0 0 0 0 0 0 0 2
2 0 0 0 0 0 0 0 0 0 2 0 0 0 0 0 0 0 0 2
2 0 0 0 0 0 0 0 0 0 2 0 0 0 0 0 0 0 0 2
2 0 2 2 2 2 2 2 2 2 2 2 2 2 0 0 0 2 2 2
2 0 0 0 0 0 0 0 0 0 0 2 0 0 0 0 0 0 0 2
2 0 0 0 0 0 0 0 0 0 0 2 0 0 0 0 0 0 0 2
2 0 0 0 0 0 0 0 0 0 0 2 0 0 0 0 0 0 0 2
2 0 0 0 0 0 0 0 0 0 0 2 0 0 0 0 0 0 0 2
2 2 2 2 2 2 2 2 2 0 2 2 2 2 2 2 2 2 0 2
2 0 0 0 0 2 0 0 0 0 0 2 0 0 0 0 0 0 0 2
2 0 0 0 0 2 0 0 0 0 0 2 0 0 0 0 0 0 0 2
2 0 0 0 0 0 0 0 0 0 0 2 0 0 0 0 0 0 0 2
2 2 2 2 2 0 2 0 2 2 2 2 0 0 0 0 0 0 0 2
2 0 0 0 0 0 2 0 0 0 0 2 0 1 0 0 0 0 0 2
2 0 0 0 0 0 2 0 0 0 0 2 0 0 0 0 0 0 0 2
2 2 2 2 2 2 2 2 2 2 2 2 2 2 2 2 2 2 2 2
9
7 8 18 6
0 1 17
0 10 14
0 3 15
1 4 10
1 8 9
2 5 5
3 15 10
5 15 15
2
3 5 16 0
15 17 17 7
levels\\level2.txt